WWWWWWWWWW
W        W
WB  S    W
W        W
W        W
W          
W        W
W    CEA W
W CT     W
WWWWWWWWWW