WWWWWWWWWW
WbRAC    W  
W      b W  
W        W 
W b      W   
WXWXXXXXXX
W          
W      B W   
WV     S W   
WWWWWWWWWW