WWWWWWWWWW
WbRAC    W  
W        W  
W        W 
W        W   
WXWXXXXXXX
W          
W      B W   
WV     S W   
WWWWWWWWWW