WWWWWWWWWW
W  A     W
W  HHHH  W
W        W
W    WXXXW
W    W    
W  SWW   W
W      S W
WBCCCb T W
WWWWWWWWWW