WWWWWWWWWW
WA AC    W  
W        W  
W        W 
W Y  A  CW   
W WXXX   X
W          
WWWW   B W   
W  R  S  W   
WWWWWWWWWW