WWWWWWWWWW
W        W
WB  S    W
W        W
W        W
W          
W        W
W        W
W        W
WWWWWWWWWW