WWWWWWWWWW
W     k  W  
W        W  
W WWWWX  W 
W A  V   W   
W      C W   
W           
W Y      W   
WB  C  S W   
WWWWWWWWWW