WWWWWWWWWW
W        W  
W    R   W  
W  WWWWX W 
W        W   
W        W   
W     B     
W        W   
WTTTTTTS W   
WWWWWWWWWW