WWWWWWWWWW
W        W
W B      W
W            
W        W
WHHHHHXXXW
W        W
W        W
W     S  W
WWWWWWWWWW