WWWWWWWWWW
W        W
WA HHHH  W
W        W
W    WXXXW
W    W    
W   WW   W
W      S W
WBCCCb T W
WWWWWWWWWW