WWWWWWWWWW
W  AC    W  
W        W  
WS       W 
W  Y   A W   
W WXXX   X
W          
WWWW   B W   
W  R     W   
WWWWWWWWWW