WWWWWWWWWW
W b      W  
W        W  
W W    b W 
W A A XX W   
W      C W   
W          
W Y   X  W   
WB  C CS W   
WWWWWWWWWW