WWWWWWWWWW
W        W
WA       W
WAA      W
W        W
W         
W        W
W        W
WB    S  W
WWWWWWWWWW