WWWWWWWWWW
W        W  
W     bC W  
W        W 
W   A XX W   
W        W   
W          
W        W   
W   B  S W   
WWWWWWWWWW