WWWWWWWWWW
W        W  
W    b C W  
W A      W 
W   A XX W   
W        W   
W          
W Y      W   
W   BC S W   
WWWWWWWWWW