WWWWWWWWWW
W AA    CW
W  HHHH  W
W    b   W
W    WXXXW
W  B W    
W  SWW   W
W    W   W
W  C   T W
WWWWWWWWWW