WWWWWWWWWW
WA AC    W  
W        W  
W        W 
W Y  Ab CW   
W WXXX   X
W          
WWW    B W   
W R  AS  W   
WWWWWWWWWW