WWWWWWWWWW
W        W
WB  S    W
W        W
W   C    W
W          
W        W
W    CEA W
W CTV    W
WWWWWWWWWW