WWWWWWWWWW
W  AC  A W  
W      C W  
WS     C W 
W  Y   C W   
W WXXX   X
W          
WWWW   B W   
W  R     W   
WWWWWWWWWW