WWWWWWWWWW
W     k  W  
W  b     W  
WA WWWWX W 
W    V   W   
W      C W   
W           
WA  Y  T W   
WB  C  S W   
WWWWWWWWWW