WWWWWWWWWW
W        W
WA HHHHY W
W      S W
W    WXXXW
W R  W    
WYYYWW   W
W        W
WBCCCb T W
WWWWWWWWWW