WWWWWWWWWW
W        W
WA HHHHY W
WA     S W
W    WXXXW
W    W    
W  YWW   W
W        W
WB  Cb T W
WWWWWWWWWW