WWWWWWWWWW
W  A   C W
W  HHHH  W
W    b   W
W    WXXXW
W  B W    
W  SWW   W
W      S W
W  C   T W
WWWWWWWWWW